111111111111
1000P0000001
1CCCCCCCCCC1
1E000000C001
100000000001
100000000001
111111111111