111111111111111111
10ECP0000000000001
111111111111111111