111111111
100000001
110000011
111111111
111111111
111111111