111111111111111111
1CECPCCCCCCCCCCCC1
1CCCCCCCCCCCCCCCC1
1CCCCCCCCCCCCCCCC1
1CCCCCCCCCCCCCCCC1
1CCCCCCCCCCCCCCCC1
111111111111111111