111111111111111111
1CECPCCC0000000001
10000000C000000001
1000000000000000C1
10000C0000000C0001
10000000000000CCC1
111111111111111111