1111111111111111111111111111111111111111
1110C0C0C0C0C0C0C0C0BBB0C0C0C0C0C0C0C0P1
1E00C0C0C0C0C0C0C0C0BBB0C0C0C0C0C0C0C111
1110C0C0C0C0C0C0C0C0BBB0C0C0C0C0C0C0C0C1
1110C0C0C0C0C0C0C0C0BBB0C0C0C0C0C0C0C0C1
1110C0C0C0C0C0C0C0C0BBB0C0C0C0C0C0C0C0C1
1110C0C0C0C0C0C0C0C0BBB0C0C0C0C0C0C0C0C1
1110C0C0C0C0C0C0C0C0BBB0C0C0C0C0C0C0C0C1
1110C0C0C0C0C0C0C0C0C0C0C0C0C0C0C0C0C0C1
1110C0C0C0C0C0C0C0C0BBB0C0C0C0C0C0C0C0C1
1110C0C0C0C0C0C0C0C0BBB0C0C0C0C0C0C0C0C1
1110C0C0C0C0C0C0C0C0BBB0C0C0C0C0C0C0C0C1
1110C0C0C0C0C0C0C0C0BBB0C0C0C0C0C0C0C0C1
1110C0C0C0C0C0C0C0C0BBB0C0C0C0C0C0C0C0C1
1110C0C0C0C0C0C0C0C0BBB0C0C0C0C0C0C0C0C1
1110C0C0C0C0C0C0C0C0BBB0C0C0C0C0C0C0C0C1
1111111111111111111111111111111111111111