1111111111
1CCCCCCCC1
11111111C1
1CCCCCCCC1
1C11111111
1CCCCCCCC1
11111111C1
1CCCCCCCC1
1C11111111
1CCCCCCCC1
11111111C1
1CCCCCCCC1
1C11111111
1CCCCCCCC1
11111111C1
1ECC1CCCC1
1P1CCC1111
1111111111