1111111111111111111111111111111111111
1000000000000000000000000000000000001
1000000000000000000000000000000000001
1000011100001111000011110001111100001
1000010100000001000000010001000100001
1000000100000001000000010001000100001
1000000100001111000011110000000100001
10000001000000010000000100P0000100001
1000000100000001000000010000000100001
1000001110001111000011110000000100001
1000000000000000000000000000000000001
10000000000000C00000000EC100000000001
1111111111111111111111111111111111111