1111111111
1111111111
1C11111C11
1CC111CC11
1CCC1CCC11
1C1CCC1C11
1C11111C11
1011111011
1E11111P11
1111111111