11111111111111111
10P000001100C00E1
10000B0000B0000B1
1000011000C011001
10C0B00000C000BB1
11111111111111111
