111111111111111111111111
100000000000000000000001
1C0000000000000000B00011
1CC000000000000000000011
1C000000000000000B000011
1B0000000000000000000011
1CCCCCCCCCCCCCCCCCCCCCC1
1CC00000000000000000C011
1CC0B000000000000000C011
1CCCCCCCCCCCCCCCCCCCCCC1
1CC00000000000000P000C01
1CC0B000000000000000C011
1C0000000000000000000011
1CE000000000000000000011
1C0000000000000000000011
100000000000000000000001
111111111111111111111111
